10 11
* ********
*     * * 
* ***** * 
* * *   * 
* * *** * 
*   *   * 
*** * * * 
*     * * 
* * * * * 
*** ***** 
          
          
          
          
          
